2,2,2,2,2,2,2,2,2,2,2,2
2,2,2,16,16,16,16,16,2,2,2,2
2,8,8,8,8,8,16,16,16,16,16,2
2,8,8,8,8,8,8,8,8,8,8,2
2,4,4,4,4,4,4,1,1,1,1,2
2,4,4,4,4,1,1,1,2,2,2,2
2,4,4,1,1,1,2,2,2,2,2,2
2,2,2,2,2,2,2,2,2,2,2,2
2,2,2,2,2,2,2,2,2,2,2,2
2,2,2,2,2,2,1,1,1,1,2,2
2,2,2,2,2,2,2,2,2,2,2,2